{
    "0": "56",
    "1": "56",
    "2": "56",
    "3": "56",
    "4": "56",
    "5": "55",
    "6": "55",
    "7": "55",
    "8": "55",
    "9": "55",
    "10": "54",
    "11": "54",
    "12": "54",
    "13": "54",
    "14": "54",
    "15": "54",
    "16": "53",
    "17": "53",
    "18": "53",
    "19": "53",
    "20": "53",
    "21": "52",
    "22": "52",
    "23": "52",
    "24": "52",
    "25": "52",
    "26": "51",
    "27": "51",
    "28": "51",
    "29": "51",
    "30": "51",
    "31": "51",
    "32": "50",
    "33": "50",
    "34": "50",
    "35": "50",
    "36": "50",
    "37": "49",
    "38": "49",
    "39": "49",
    "40": "49",
    "41": "49",
    "42": "48",
    "43": "48",
    "44": "48",
    "45": "48",
    "46": "48",
    "47": "47",
    "48": "47",
    "49": "47",
    "50": "47",
    "51": "47",
    "52": "46",
    "53": "46",
    "54": "46",
    "55": "46",
    "56": "46",
    "57": "45",
    "58": "45",
    "59": "45",
    "60": "45",
    "61": "44",
    "62": "44",
    "63": "44",
    "64": "44",
    "65": "44",
    "66": "43",
    "67": "43",
    "68": "43",
    "69": "43",
    "70": "43",
    "71": "42",
    "72": "42",
    "73": "42",
    "74": "42",
    "75": "41",
    "76": "41",
    "77": "41",
    "78": "41",
    "79": "41",
    "80": "40",
    "81": "40",
    "82": "40",
    "83": "40",
    "84": "39",
    "85": "39",
    "86": "39",
    "87": "39",
    "88": "38",
    "89": "38",
    "90": "38",
    "91": "38",
    "92": "37",
    "93": "37",
    "94": "37",
    "95": "37",
    "96": "36",
    "97": "36",
    "98": "36",
    "99": "36",
    "100": "36"
}